11111111111111111111
1BC0000000E000000BC1
10101010101010101C11
10011001100110011001
10001110001110001111
10001110C01110001111
10011001100110011001
1010101010101B101011
1P0000000000000C0001
11111111111111111111